SO img/sud.xpm
NO img/nord.xpm
EA            img/est.xpm
WE img/ouest.xpm

C 255,30,8
F 220,100,  120
1111111111111111111111111 111
1000000000110000000000001 100
11111000001110000000000001 11
   100100000000000000000001
1111111110110000011100000001111111110
 10000000001100001110111111111111
111110111111111011100000010001
111010101110000011000000110011
1111011111111101111010010001
10000000000000000000000000100
1000000000000000101010011010
1100000111010101111101100W01111
11110111 1110101 101110010101
11111111 1111111 11111111111