SO img/sud.xpm
NO img/nord.xpm
EA            img/est.xpm
WE img/ouest.xpm

C 255,30,8
F 220,100,  120
1111111111111111111111111
1000000000110000000000001
1011000001110000000000001
   1001000000000000000000001
1111111110110000011100000000011111110001
 10000000001100001110111111111111
011110111111111011100000010001
111010101110000011000000010001
1111011111111101111010010001
10000000000000001100000010001
1000000000000000101010010001
1100000111010101111101111W00111
11110111 1110101 101111010001
11111111 1111111 111111111111