SO ./path_to_the_north_texture
SO ./path_to_the_south_texture
EA            ./path_to_the_east_texture
WE ./path_to_t   he_west_texture
C 255,30,8
F 220,100,  120
1111111111111111111111111
1000000000110000000000001
1011000001110000000000001
   1001000000000diego000000000001
111111111011000001110000000000001
 10000000001100trop001110111111111111
011110111111111011100000010001
111010101110000011000000010001
11110111111111011101010010001
1000000000moche0000001100000010001
10000000000000001101010010001
11000001110101011111011110N0111
11110111 1110101 101111010001
11111111 1111111 111111111111