SO img/sud.xpm
NO img/nord.xpm
EA     img/est.xpm
WE img/ouest.xpm

C 26, 78,255
F 12,66,12
1111111111
100E000001
1000000001
1000001001
1000001001
1111111111
